A #############################
  # # #   # #   # #     # #   #
# # # # ### # ### ### ### ### #
#     # #     # #   #       # #
# ##### # # ### # ### # ### # #
#   #   # #   # #     # # #   #
# # ### ### ### ######### # ###
# #     #         #     #   # #
# # ##### ### ####### ### ### #
#   #   #   # # #     #     # #
# ##### # # # # ### # ### ### #
# #   #   # # #   # # #       #
# # ### ##### ### ### ### ### #
#     # #   # # #   # #   #   #
# # ####### # # ### # ####### #
# #               # #         #
# # ### # # ##### # ### ### # #
# # # # # # # #         # # # #
# # # # ##### ### ### ### #####
#     #         #   #         #
# ### # ### ####### ### ##### #
# #   #   #     #   # # #   # #
# # # ############### ### #####
# # #   # # #   # # #   # #   #
# # ##### # # # # # ### # # ###
#   # #       # #   # # #     #
# ### # ####### # ### # ### # #
#         # #     #         # #
# ####### # ##### # # ####### #
#       #       #   #     #    
############################# B