A #   ####     #                                  
#   # #    ### #                        ###       
 ####   ###### #                       #   #      
  ######   #   #           ####       #  # #      
   ##      # ##           #    ##    #  ##  ##    
 #         #   #          # ##   #  #  #  #   #   
  ## #      ## #          #  ### ## # #    ## #   
# ## ###### ## #          ## # #   #  #   ###  #  
  ##       #   #         #   # ### # #   #   # #  
 ######### # ##        ### ##   #  # # ##  #   #  
 #########   #        #    #  #   #  #    # ###   
   ##########        #  #### #####  #  ###        
## #######       ##### ##  # ####  ## #           
 #        #     #    #   # #  ##  # # #           
  #######  ###  # ##  ## #  # #  ##   #######     
     #   #    ###  ##    #  #   # # ###      #    
     # #  ###   ## # ####    ###  #     #### #    
     #  #  #### #  #               #####  #  #    
      #  # #    # #                     #   #     
       # #   ###  #                     # ##      
      ## ####    #                      # #       
     #   #    ###                       # #       
     # ##      #                        # #       
     #   #   # #                        #  #      
      ##  #  # #                         # ####   
        #  # # #                        #  #   ## 
         # ###  ##                      # #  #    
         #    #   #                    #  # ##### 
          ### ### #                      #  ##### 
                  #                        ######B