###############
#             #
# ## ## ##### #
# ## ## #   # #
#    ## # # # #
# ## ## ### # #
# ## ##     # #
# ## ######## #
# #         # B
A #############