A        #
## ##### #
         #
 ### #####
 ###     #
 ######  #
 ###     #
 ### #####
         B
##########