#  B#   #      
  ##  # #      
 #   #  #      
 # ### #       
 # A##  #      
  ##### #      
 ###### #      
 #      #      
 # #####       
   #           
  #            
               
               
               
               