A  ######################
#        #        #  #  #
#  #  ####  ####  #  #  #
#  #     #  #  #        #
#  #######  #  #  #  ####
#                 #     #
#  #######  ####  #  ####
#     #        #     #  #
####  #  #############  #
#B #        #  #        #
#  #  ####  #  #  #######
#           #  #  #     #
#  #######  #  #  ####  #
#  #                    #
##########  ####  ####  #
#              #  #     #
#########################